31
1111111111111111111111111111111
1010001000000000001000000000001
1010101010111011111010111111101
1000101010100010000010000010001
1111101110111010111111111010111
1000100010001010000010100010001
1011111010101111111010101111111
1010001010100000100000100010001
1010101010111110101111101010101
1010100010100010001000101010101
1010111110101011111010101010101
1010000010001000100010101000101
1011111011111011101110101111101
1000001010000010001010100010001
1010101010111110111010111110101
1010101010001010100010000010101
1010111011101010111011111010111
1010000010001010001000001010001
1011111110111011101110101010101
1000100000000010001000101010101
1110111111111110111011111011101
1010001000001000100010001010001
1011101011101011101110101010111
1000001010000010000010100010001
1011111011111111111010111111101
1000100000100000000010000000001
1110111110101011111111111111101
1010100010101000001000001000101
1010101010101111101011101010101
1000001000100000100000100010001
1111111111111111111111111111111